10
14
0 0 0 0 0 0 0 0 0 0 0 0 0 0 
0 11 0 0 0 0 0 0 0 0 0 0 0 0 
0 0 0 -11 11 0 0 0 0 0 0 0 20 0 
11 0 0 0 0 0 -11 0 0 0 0 0 0 0 
0 11 0 0 0 0 0 0 0 0 0 0 24 0 
0 0 0 10 0 0 0 0 0 0 23 0 0 0 
0 -11 0 0 0 0 0 0 0 0 0 0 0 0 
0 0 0 -10 0 23 0 23 0 0 0 0 0 0 
0 0 0 0 -11 0 0 0 0 0 0 0 0 0 
0 0 0 0 0 0 0 0 0 0 0 0 0 0 
