10
14
150
50
22 22 22 22 22 22 22 22 22 22 22 22 22 22 
22 0 0 0 0 0 0 0 0 0 22 22 22 22 
22 0 0 0 22 22 22 22 0 0 22 22 -10 22 
22 0 10 21 21 21 -10 22 0 0 22 22 0 22 
22 0 0 0 0 0 0 0 0 0 0 0 0 22 
22 0 10 21 21 21 0 22 10 0 0 0 -10 22 
22 0 0 0 10 0 0 22 0 0 0 21 21 22 
22 -10 10 22 22 22 22 22 0 0 0 21 21 22 
22 -10 0 0 0 0 0 0 0 0 0 0 0 22 
22 22 22 22 22 22 22 22 22 22 22 22 22 22 
4
7
