10
10
0 0 0 0 0 0 0 0 0 0
1 0 1 1 1 1 1 1 1 1
3 0 0 0 0 5 0 4 5 6
1 2 0 2 0 0 0 0 0 0
0 0 0 0 0 0 0 0 0 0
0 0 0 0 0 0 0 0 0 0
0 0 0 0 0 0 0 0 0 0
0 0 0 0 0 0 0 0 0 0
0 0 0 0 0 0 0 0 0 0
0 0 0 0 0 0 0 0 0 0
