10
14
120
56
22 22 22 22 22 0 0 0 0 0 0 0 0 0 
22 0 0 0 22 22 22 22 22 22 22 22 22 22 
22 0 11 0 0 0 0 0 0 0 11 0 0 22 
22 22 11 22 0 22 0 0 22 -11 22 0 0 22 
22 0 0 0 0 0 0 0 -11 -11 -11 0 0 22 
22 0 11 0 11 0 0 0 22 -11 22 22 22 22 
22 22 22 22 22 0 0 0 0 0 0 22 0 0 
0 0 0 0 22 22 0 0 0 0 0 22 0 0 
0 0 0 0 0 22 22 0 0 0 0 22 0 0 
0 0 0 0 0 0 22 22 22 22 22 22 0 0 
1
2
