10
14
214
50
0 0 0 0 0 0 0 0 20 0 0 0 0 0 
0 11 0 11 0 13 0 0 20 0 0 0 0 0 
0 0 11 0 12 0 0 20 20 0 0 0 0 0 
20 0 0 10 0 0 20 20 20 0 0 0 0 0 
20 20 0 -11 0 0 0 20 20 0 0 0 0 0 
20 0 -11 0 -11 0 0 0 20 0 0 0 0 0 
20 -13 0 -12 0 -10 0 20 20 0 0 0 0 0 
20 0 0 0 0 0 0 20 0 0 0 0 0 0 
20 20 0 0 0 0 0 20 0 0 0 0 0 0 
0 20 0 0 0 0 0 20 0 0 0 0 0 0 
0
0