10
14
150
90
21 24 21 24 21 0 0 0 0 0 0 0 0 0 
24 0 0 0 24 0 0 0 0 0 0 0 0 0 
21 0 13 0 21 0 0 0 0 0 0 0 0 0 
24 21 0 0 24 0 0 0 0 0 0 0 0 0 
21 -13 -12 0 21 24 21 24 21 0 0 0 0 0 
24 -12 -10 13 12 -13 10 -10 24 0 0 0 0 0 
21 -10 0 0 12 0 10 10 21 0 0 0 0 0 
24 0 0 0 0 0 0 0 24 0 0 0 0 0 
21 0 0 0 0 0 0 0 21 0 0 0 0 0 
24 21 24 21 24 21 24 21 24 0 0 0 0 0 
4
3
