10
14
150
50
0 0 0 24 24 24 24 24 24 24 0 0 0 0 
0 0 0 24 0 0 24 0 0 24 0 0 0 0 
0 24 24 24 11 -11 -11 -11 11 24 24 24 0 0 
0 24 0 0 11 -11 0 -11 11 0 0 24 0 0 
0 24 0 24 11 -11 -11 -11 11 24 0 24 0 0 
0 24 0 24 0 0 24 0 0 24 0 24 0 0 
0 24 0 24 11 11 24 24 24 24 0 24 0 0 
0 24 0 0 0 0 0 0 0 0 0 24 0 0 
0 24 24 24 24 24 24 24 24 24 24 24 0 0 
0 0 0 0 0 0 0 0 0 0 0 0 0 0 
7
6
