10
14
120
40
20 20 0 0 0 20 20 20 20 20 20 20 20 20 
20 20 0 0 12 0 0 0 0 0 -12 0 0 20 
20 20 0 12 -12 -12 -12 0 12 0 20 12 0 20 
20 20 0 0 -12 12 12 -12 0 0 20 0 0 20 
20 20 20 0 -12 12 0 12 -12 12 20 0 0 20 
20 20 20 0 0 -12 12 12 -12 0 20 0 0 20 
20 20 20 0 12 0 -12 -12 -12 0 20 0 0 20 
20 20 20 -12 0 0 12 0 12 0 20 12 0 20 
20 20 20 0 20 20 20 20 20 0 -12 0 0 20 
20 20 20 0 0 0 0 0 0 0 20 0 0 20 
4
6
