10
14
1
1
0 0 0 24 24 24 24 24 24 24 0 0 0 0 
0 0 0 24 0 0 24 0 0 24 0 0 0 0 
0 24 24 24 11 -11 -11 -11 11 24 24 24 0 0 
0 24 0 0 11 -11 0 -11 11 0 0 24 0 0 
0 24 0 24 11 -11 -11 -11 11 24 0 24 0 0 
0 24 0 24 0 0 24 0 0 24 0 24 0 0 
0 24 0 24 11 11 24 24 24 24 0 24 0 0 
0 24 0 0 0 0 0 0 0 0 0 24 0 0 
0 24 24 24 24 24 24 24 24 24 24 24 0 0 
0 0 0 0 0 0 0 0 0 0 0 0 0 0 
150
50
